0 *x*S -> E 0
0 *E*x -> S 0
0 *E*S -> W 2
1 **Wx -> S 1
1 **xS -> W 2
2 N*x* -> W 2
2 x*W* -> N 3
3 xE** -> N 3
3 Nx** -> E 0
